Held Items

Butterfree - Silver Powder (Route 47 w/Waterfall)
Beedrill - Poison Barb (Route 47 w/Waterfall)
Fearow - Sharp Beak (Route 42 atm)
Arbok - Shed Shell (Route 42) (cause Seviper has it)
Pikachu - Light Ball (???)
Sandslash - Grip Claw (Union Cave B2F)
Clefable - Moon Stone (???)
Paras - Tiny Mushroom (Ilex Forest)
Parasect - Big Mushroom (???)
Venomoth - Shed Shell (Route 43)
Dugtrio - Soft Sand (Union Cave B2F)
Persian - Quick Claw (???)
Kadabra - Twisted Spoon (Route 34)
Machoke - Focus Band (Cliff Cave)
Tentacruel - Poison Barb (Lots with Surf)
Graveler - Hard Stone (Union Cave B2F) (Everstone sucks)
Magneton - Magnet (Victory Road) (instead of M. Coat)
Farfetch'd - Leek (Route 38)
Dodrio - Sharp Beak (Route 27)
Grimer - Black Sludge (Burned Tower)
Muk - Black Sludge (???)
Shellder - Pearl (New Bark Town)
Cloyster - Big Pearl (???)
Cubone - Thick Club (Mt. Mortar)
Marowak - Thick Club (Mt. Mortar)
Koffing - Smoke Ball (Burned Tower)
Weezing - Smoke Ball (???)
Chansey - Lucky Egg (Route 48)
Staryu - Stardust (Cherrygrove City)
Starmie - Star Piece (???)
Lapras - Mystic Water (Union Cave B2F)
Snorlax - Leftovers (Vermilion City)
Mew - Lum Berry (??)

Lanturn - Deep Sea Scale (Route 27)
Yanma - Wide Lens (Route 35)
Murkrow - Nugget (Ilex Forest)
Steelix - Metal Coat (Cliff Cave... Maybe if I take it out of there?)
Shuckle - Berry Juice (Slowpoke Well? Route 40?)
Sneasel - Quick Claw (Ice Path)
Teddiursa - Honey (Dark Cave)
Skarmory - Metal Coat (Route 45 North)
Miltank - Moomoo Milk (Route 38)
Ho-oh - Sacred Ash (Bell Tower)
Celebi - Lum Berry (??)

Zigzagoon - Potion (Route 29)
Linoone - Max Revive (Route 27)
Beautifly - Shed Shell (???)
Dustox - Shed Shell (???)
Lombre - Mental Herb (Route 43)
Nuzleaf - Power Herb (???)
Wingull - Pretty Feather (Route 32) - if exists
Pelipper - Pretty Feather (Surfing)
Surskit - Honey (Route 30)
Masquerain - Silver Powder (Route 30 Surfing)
Shroomish - Tiny Mushroom (Ilex Forest)
Breloom - Big Mushroom (???)
Hariyama - Black Belt (Union Cave B2F) (not King's Rock!)
Sableye - Wide Lens (Union Cave B2F)
Mawile - Iron Ball (Union Cave B2F)
Lairon - Hard Stone (Dark Cave Blackthorn)
Volbeat - Bright Powder (Route 35)
Illumise - Bright Powder (Route 35)
Gulpin - Oran Berry (Route 33)
Swalot - Sitrus Berry (???)
Sharpedo - Deep Sea Tooth (Route 41)
Torkoal - Charcoal (Route 45)
Cacnea - Sticky Barb (Safari Zone)
Zangoose - Quick Claw (Route 42)
Seviper - Shed Shell (Route 42)
Lunatone - Moon Stone (Mt. Mortar)
Solrock - Sun Stone (Mt. Mortar)
Claydol - Light Clay (??)
Banette - Spell Tag (Bell Tower)
Dusclops - Spell Tag (Bell Tower)
Chimecho - Spell Tag (Bell Tower)
Glalie - Never-Melt Ice (Ice Path Lower)
Clamperl - Pearl (Route 40)
Huntail - Deep Sea Tooth (??)
Gorebyss - Deep Sea Scale (??)
Relicanth - Deep Sea Scale (Whirl Islands)
Luvdisc - Heart Scale (Route 47)
Shelgon - Dragon Fang (Dragon's Den)
Metang - Metal Coat (Ice Path Lower)
Jirachi - Star Piece (??)

Kricketune - Metronome (Route 33)
Wormadam - Silver Powder (Route 39)
Mothim - Silver Powder (Route 39)
Combee - Honey (Cherrygrove)
Vespiquen - Poison Barb (Route 27)
Cherubi - Miracle Seed (National Park)
Cherrim - Miracle Seed (??)
Drifblim - Air Balloon (Route 40) (maybe change to Route 47?)
Bronzong - Metal Coat (Bell Tower)
Happiny - Lucky Punch (National Park)
Chatot - Metronome (Route 40)
Spiritomb - Smoke Ball
Gabite - Dragon Fang (Dragon's Den) (not Haban)
Munchlax - Oran Berry (Route 46) (Maybe change to Route 45?)
Drapion - Poison Barb (??)
Abomasnow - Never-Melt Ice (Mt. Silver)
Shaymin - Lum Berry (??)

Boldore - Hard Stone (Dark Cave Blackthorn)
Audino - Sitrus Berry (Route 48)
Throh - Black Belt (Route 40)
Sawk - Black Belt (Route 40)
Basculin-R - Deep Sea Tooth (Safari Zone)
Basculin-B - Deep Sea Scale (Safari Zone)
Sandile - Black Glasses (Safari Zone)
Maractus - Miracle Seed (Safari Zone)
Crustle - Hard Stone (Cliff Cave)
Scrafty - Shed Shell (Route 27)
Trubbish - Silk Scarf (Route 33)
Vanillish - Never-Melt Ice (Ice Path Lower)
Foongus - Tiny Mushroom (Safari Zone)
Amoonguss - Big Mushroom (??)
Ferroseed - Sticky Barb (Mt. Mortar)
Ferrothorn - Sticky Barb (Mt. Mortar 2)
Cryogonal - Never-melt Ice (Ice Path Lower)
Golett - Light Clay (Safari Zone) - iffy on this
Druddigon - Dragon Fang (Dragon's Den)
Goomy - Shed Shell (Safari Zone)

Maybe but probably cant be caught:
Ninetales - Charcoal (???)
Castform - Mystic Water (???)
Weavile - Quick Claw (??)
Lickilicky - Lagging Tail (??)
Electivire - Electirizer (??)
Magmortar - Magmarizer (??)
Yanmega - Wide Lens (??)
Probopass - Magnet (??)
Dusknoir - Spell Tag (??)
Bisharp - Leader's Crest (??)
Volcarona - Silver Powder (??)
Aggron - Hard Stone (???)
Cacturne - Sticky Barb (???)
Salamence - Dragon Fang (??)
Metagross - Metal Coat (??)
Roserade - Poison Barb (??)
Garchomp - Dragon Fang (???)
Cofagrigus - Spell Tag (??)
Golurk - Light Clay (??)

Not sure:
Slowpoke - Lagging Tail
Lickitung - Lagging Tail
Seaking - Mystic Water
Ditto - Powders
Slowbro/king - King's Rock