JOHTO HALF
Abomasnow - Defeat Pryce (REMATCH)
Absol - Burned Tower
Altaria - Defeat Clair (REMATCH)
Ampharos - Defeat Ethan/Lyra @ Victory Road
Audino - Route 29
Beedrill - Ilex Forest
Gengar - Defeat Morty (REMATCH)
Glalie - Ice Path
Gyarados - Lake of Rage
Lopunny - Defeat Whitney (REMATCH)
Mawile - Victory Road
Medicham - Defeat Chuck (REMATCH)
Pidgeot - Defeat Falkner (REMATCH)
Sableye - Victory Road
Scizor - Defeat Bugsy (REMATCH)
Sharpedo - Cherrygrove City
Slowbro - Slowpoke Well

KANTO HALF
Aerodactyl - Pewter Museum
Aggron - Rock Tunnel
Alakazam - Saffron City (Mr. Psychic's House)
Banette - Lavender Town somewhere
Blastoise - From Prof. Oak at Olivine Harbour
Blaziken - Steven in Silph Co
Camerupt - Cinnabar Island???
Charizard - From Prof. Oak at Olivine Harbour (both)
Diancie - Some sort of legendary event
Gallade - Some kind of side quest?
Garchomp - Defeat Cynthia
Gardevoir - Some kind of side quest?
Groudon - Legendary event
Heracross - Viridian Forest
Houndoom - Route 7
Kangaskhan - Fuchsia City
Kyogre - Legendary event
Lucario - Mt. Silver
Manectric - Vermilion City
Metagross - Defeat Steven
Mewtwo - Legendary event
Pinsir - Viridian Forest
Rayquaza - Automatic
Salamence - Defeat Lance (REMATCH - ROUND 2)
Sceptile - Steven in Silph Co
Steelix - Defeat Jasmine (REMATCH)
Swampert - Steven in Silph Co
Tyranitar - Defeat Blue
Venusaur - From Prof. Oak at Olivine Harbour